#######
#  *  #
#     #
#     #
#     #
#     #
#######